1111111111111111111
1210000000000000001
1010000000000000001
1010000000000000001
1010000000000000001
1011111111111111111
1000000000000000031
1111111111111111111
1000000000000000001
1000000000000000001
1000000000000000001
1000000000000000001
1000000000000000001
1000000000000000001
1000000000000000001
1000000000000000001
1000000000000000001
1000000000000000001
1000000000000000001
1111111111111111111